11111111111
1P000000011
101100C0111
1C1C00011E1
11111111111